0000000000000000000000000000
0000000800000500000080000000
0000000311111111111130000000
0000000200044444400020000000
0000000200044444400020000000
0000000270044444407020000000
0009311111111111111311110000
0000200020000000000200020000
0000207020000090000207020000
0003111111111111111111113900
0002000000000200000000002000
0002000700000200700700002000
0011111113111111113111111300
0020000002000000002000000200
0020070002000000002000070200
0311111111111311111111111130
0200000000000200000000000020
0200060000000200000000000020
1111111111111111111111111111