000000000000000000000
000000000000000000000
000000044440000000000
000000044444000000000
000008044444050800000
000013111111111310000
000002000000000200000
000002000000700200000
000011111133111119000
000000000022000000000
000000000022000000000
000000000722000000000
000000113111311000000
000000002000200000000
000000002000200000000
000003111111111300000
000002000000000200000
000002000600000200000
000111111111111111000
000000000000000000000